########################################################################################################################
#           ########                                                                                                   #
#            ########                     ##############################################################       ####    #
#             ########                                             #                                   ##    ######   #
#             ########                 #            #              #                    #                ##   ####    #
#             ########                 #            #                                   #                  ##         #
#         ###############              #          ###############################     #########            ##          #
#                                      ##############                                         #           ###  #       #
#         ###############                           #             ##########   ####           #             #  #       #
#           ########                                #             #        #   #  #         ###           ###  #       #
#          ########                              ####                                      #                   #       #
#          ########                                                                        #        #########  #       #
#         ########                                                                         #                #  #       #
#        ########                                ####                                      #              ###  #       #
#        ########       #####                       #                 #   #                 ##########         #       #
#        ########      #######                      #                 #####                   #                #       #
#        ########       #####             ##########                                          #                #       #
#         ########                        #        ################################     ######               ##       #
#         ########                        #        #                              #     #                  ##         #
#         ########                        #        #               #              #     #                ##           #
#          ########                       #                    #                  ##     #         ##             #    #
#           #########                     #              ###                       #       #                           #
#    ###      #########                   #                                         #                         ####     #
#   #####  ###################            #                                          #     ###               ######    #
#    ###                            ########            ###                        #####               ####     #      #
#            ####################                             #####                        ###                         #
#                    #########                                 ###                                                     #
########################################################################################################################
