########################################################################################################################
#           ########                                                                                                   #
#            ########                     ##############################################################       ####    #
#             ########                   #                          #                                   ##    ######   #
#             ########                  #            #              #                    #                ##   ####    #
#             ########                  #            #                                   #                  ##         #
#         ###############                #           ###############################     ######               ##       #
#                                         ###########                                         #           ###  #       #
#         ###############                           #             ##########   ####           #             #  #       #
#           ########                                #             #        #   #  #         ###           ###  #       #
#          ########                              ####                                      #                   #       #
#          ########                                                                        #              ###  #       #
#         ########                                                                         #                #  #       #
#        ########                                ####                                      #              ###  #       #
#        ########       #####                       #                 #   #                 ###                #       #
#        ########      #######                      #                 #####                   #                #       #
#        ########       #####             ##########                                          #                #       #
#         ########                       #          ################################     ######               ##       #
#         ########                      #           #                                    #                  ##         #
#         ########                      #           #               #                    #                ##           #
#          ########                      #                          #                                   ##             #
#           #########                     ##############################################################               #
#    ###      #########                                                                                       ####     #
#   #####       ########                                                                   ###               ######    #
#    ###         ##########                                    ###                        #####               ####     #
#                   ########                                  #####                        ###                         #
#                    #########                                 ###                                                     #
########################################################################################################################
