########################################################################################################################
#                                                                                                                      #
#                #                                                               #########     #########     ###########
#                #                                                       ##########     ########       #######         #
#                ##############                     #####              ##     #  #########     #########     ###########
#                             #                                       #       #                                        #
#                             #                                       #     ##                                         #
#                             #            #####                       #####                                           #
#                                                                      #                                               #
###############################                                     #####                                              #
#                  #                                #####          #     #                                             #
#                  #                                               #     #                                             #
#                  #                                               #     #                                             #
#                  #                                               #     #                                             #
#                  #                                               #######                                             #
#                  #                                                                    ##########                     #
#                  #                                                                    #        #                     #
######     #####################                                                    #####        ######                #
#                                                                                   #                 #                #
#                                                                                   #                 #                #
#                                                     ###                           #                                  #
#                                                     ###                           #                                  #
#                                                     ###                           #                 #                #
#                                                     ###                           ###################                #
#                                                     ###                                                              #
#                                                     ###                                                              #
#                                                     ###                                                              #
########################################################################################################################
